111111111111
1P0000000001
111110111011
1000C0000001
101111011111
10C000000001
101110110111
1000C0100001
111000101111
100000000E01
111111111111