111111111111111
1P000C000000001
101111111111101
101000000000101
101011111110101
101000000110001
101010101010101
1010101C1010101
101010101010101
101010000010101
101011111110101
101000000000101
101111111111101
10000000000C0E1
111111111111111