NO ./textures/north.xpm
SO ./textures/south.xpm
WE ./textures/west.xpm
EA ./textures/east.xpm

F 100,100,100
C 200,200,200

111111111
100000001
100000001
100010001
10000E001
100000001
111111111
