NO ./textures/north.xpm
SO ./textures/south.xpm
WE ./textures/west.xpm
EA ./textures/east.xpm

F 50,50,50
C 150,150,150

  1111
  1001
111001
100W01
111111
