NO ./textures/north.xpm
SO ./textures/south.xpm
WE ./textures/west.xpm
EA ./textures/east.xpm

F 220,10,0
C 225,10,100

111
1S1
111

111111
101001
110001
100001
100001
111111

    111
111100011111
10000000001
100000000001
100000000001
11111111111
11111001
11001111
11111
