NO ./textures/NO_test.xpm
SO ./textures/SO_test.xpm
WE ./textures/WE_test.xpm
EA ./textures/EA_test.xpm

F 200,0,0
C 50,50,50

111
1W1
111

111111
101001
110001
100001
100101
111111

    111
111100011111
10000000001
100000000001
100000000001
11111111111
11111001
11001111
11111

1111111111111111111111111
1000000000000000000000001
1000000000000000000000001
1000000010000000000000001
1000000001000000000000001
1000000000100000000000001
1000000000000000001000001
1000000000000000001000001
1000000000000000001000001
1000000000000000000000001
1000000000000000000000001
1000000000000000000000001
1111111111111111111111111