111111
10P0E1
101011
100001
111111