1111111111
1P00000C01
1010111011
1010000001
1011111101
1000000001
1111011011
1C000001E1
1111111111