1111111111
1P00000001
1111111001
10C1000101
11110E0101
1000011101
1011110001
100C000001
1111111111