11111
1P0C1
100E1
11111
     
99999